**********
*f  o   **
*  p   *#*
*      *d*
*        *
*        *
*d*      *
*#*  P   *
**    o f*
**********